言葉	読み方	起源
鐙	あぶみ	足踏み（あ|ぶみ）
礎	いしずえ	石据ゑ（いし|ずゑ）
泉	いずみ	出づ水（いづ|み）
営む	いとなむ	暇無む（いと|なむ）
蝗	いなご	稲子（いな|ご）*
古	いにしえ	往にし方（いにし|へ）
猪	いのしし	猪の獣（ゐ|の|しし）
諱	いみな	忌み名（いみ|な）
彩り	いろどり	色取り（いろ|どり）
巌	いわお	岩穂（いは|ほ）
承る	うけたまわる	受け賜る（うけ|たまわる）
団扇	うちわ	打ち羽（うち|は）
描く	えがく	絵掻く（ゑ|がく）
靨	えくぼ	笑窪（え|くぼ）
榎	えのき	榎の木（え|の|き）
概ね	おおむね	大旨（おほ|むね）
丘	おか	峰処（を|か）
諡	おくりな	贈り名（おくり|な）
陥る	おちいる	落ち入る（おちいる）
陥れる	おとしいれる	落とし入れる（おとしいれる）
乙女	おとめ	若女（をとめ）
男	おとこ	若子（をと|こ）
男	おのこ	男の子（を|の|こ）
面	おもて	面方（おも|て）
赴く	おもむく	面向く（おも|むく）
蚕	かいこ	飼ひ蚕（かひ|こ）
顧みる	かえりみる	返り見る（かへり|みる）
鏡	かがみ	影見（かが|み）*
芳しい	かぐわしい	香細し（か|ぐはし）
象る	かたどる	形取る（かた|どる）
傾く	かたむく	片向く（かた|むく）
雷	かみなり	神鳴り（かみ|なり）
蚊帳	かや	蚊屋（か|や）
兆し	きざし	気指し（き|ざし）
築く	きずく	城築く（き|づく）
絆	きずな	木綱（き|づな）
茸	きのこ	木の子（き|の|こ）
漱ぐ	くちすすぐ	口濯ぐ（くち|すすぐ）
轡	くつばみ	口食み（くつ|ばみ）*
轡	くつわ	口輪（くつ|わ）*
距	けづめ	蹴爪（け|づめ）
獣	けもの	毛物（け|もの）
志	こころざし	心指し（こころ|ざし）
志す	こころざす	心指す（こころ|ざす）
試みる	こころみる	心見る（こころ|みる）
快い	こころよい	心良し（こころ|よし）
梢	こずえ	木末（こ|ずゑ）
理	ことわり	事割り（こと|わり）
断る	ことわる	言割る（こと|わる）
杯	さかずき	酒坏（さか|づき）*
魚	さかな	酒菜（さか|な）*
魁	さきがけ	先駆け（さき|がけ）
挟む	さしはさむ	差し挟む（さし|はさむ）
幸せ	しあわせ	仕合はせ（し|あはせ）
鹹い	しおからい	塩辛し（しほ|からし）
躾	しつけ	仕付け（し|つけ）
簾	すだれ	簀垂れ（す|だれ）
背く	そむく	背向く（そ|むく）
薪	たきぎ	焚き木（たき|ぎ）
筍	たけのこ	竹の子（たけ|の|こ）
襷	たすき	手繦（た|すき）
奉る	たてまつる	立て奉る（たて|まつる）
七夕	たなばた	棚機（たな|ばた）
卵	たまご	玉子（たま|ご）
保つ	たもつ	手持つ（た|もつ）*
袂	たもと	手本（た|もと）*
頼る	たよる	手寄る（た|よる）*
司る	つかさどる	官取る（つかさ|どる）
培う	つちかう	土養ふ（つち|かふ）
唾	つばき	唾吐き（つ|ばき）
躓く	つまずく	爪付く（つま|づく）*
鎖す	とざす	戸鎖す（と|ざす）
擲つ	なげうつ	投げ打つ（なげ|うつ）
膠	にかわ	煮皮（に|かは）
鶏	にわとり	庭鳥（には|とり）
捗る	はかどる	計取る（はか|どる）
儚い	はかない	計無し（はか|なし）
謀	はかりごと	謀り事（はかり|ごと）
羽	はね	羽根（は|ね）
腸	はらわた	腹腸（はら|わた）
磔	はりつけ	張り付け（はり|つけ）
率いる	ひきいる	引き居る（ひき|ゐる）
庇	ひさし	日差し（ひ|さし）
酷い	ひどい	非道し（ひ|ど|し）
偏	ひとえ	一重（ひと|へ）
檜	ひのき	檜の木（ひ|の|き）
飢い	ひもじい	ひ文字（ひ|もじ）
繙く	ひもとく	紐解く（ひも|とく）
再び	ふたたび	二度（ふた|たび）
酸漿	ほおずき	頬付き（ほほ|づき）
炎	ほのお	火の穂（ほ|の|ほ）*
前	まえ	目方（ま|へ）*
誠	まこと	真事（ま|こと）
瞬き	またたき	目叩き（ま|たたき）*
瞬く	またたく	目叩く（ま|たたく）*
睫	まつげ	目つ毛（ま|つ|げ）*
政	まつりごと	祭り事（まつり|ごと）
窓	まど	目戸（ま|ど）*
眼	まなこ	目な子（ま|な|こ）*
瞬き	まばたき	目叩き（ま|ばたき）*
瞼	まぶた	目蓋（ま|ぶた）*
見える	まみえる	目見ゆ（ま|みゆ）*
守る	まもる	目守る（ま|もる）*
帝	みかど	御門（み|かど）
湖	みずうみ	水海（みづ|うみ）
導く	みちびく	道引く（みち|びく）
孤	みなしご	身無し子（み|なし|ご）
源	みなもと	水な本（み|な|もと）
醜い	みにくい	見憎し（み|にくし）
蝕む	むしばむ	虫食む（むし|ばむ）
娘	むすめ	産す女（むす|め）
眼鏡	めがね	目金（め|がね）
用いる	もちいる	持ち率る（もち|ゐる）
弄ぶ	もてあそぶ	持て遊ぶ（もて|あそぶ）
櫓	やぐら	矢倉（や|ぐら）
縁	よすが	寄す処（よす|が）
蘇る	よみがえる	黄泉帰る（よみ|がへる）
暁	あかつき	明時（あか|とき）
妹	いもうと	妹人（いも|ひと）
補う	おぎなう	置き縫ふ（おき|ぬふ）
夫	おっと	男人（を|ひと）
弟	おとうと	弟人（おと|ひと）
大臣	おとど	大殿（おほ|との）
囮	おとり	招き鳥（をき|とり）
慮る	おもんぱかる	思ひ量る（おもひ|はかる）
神楽	かぐら	神座（かむ|くら）*
鍛冶	かじ	金打ち（かね|うち）
芳しい	かんばしい	香細し（か|ぐはし）
唇	くちびる	口縁（くち|べり）
硯	すずり	墨研り（すみ|ずり）
築地	ついじ	築き泥（つき|ひぢ）
一日	ついたち	月立ち（つき|たち）
汝	なんじ	汝貴（な|むち）
喉	のど	飲み門（のみ|と）
入る	はいる	這ひ入る（はひ|いる）
裸	はだか	肌赤（はだ|あか）
裸足	はだし	肌足（はだ|あし）
秀でる	ひいでる	穂出づ（ほ|いづ）
筆	ふで	文手（ふみ|て）
柳	やなぎ	矢篦木（や|の|き）
改める	あらためる	新たむ（あらたむ）
慈しむ	いつくしむ	傅くしむ（いつくしむ）
戒める	いましめる	忌ましむ（いましむ）
生まれる	うまれる	産まる（うまる）
思惑	おもわく	思はく（おもはく）
氷	こおり	凍り（こほり）
相撲	すもう	争ふ（すまふ）
山車	だし	出し（だし）
塵	ちり	散り（ちり）
辱める	はずかしめる	恥づかしむ（はづかしむ）
林	はやし	生やし（はやし）
飯	めし	召し（めし）